1 1
1
16 10
077 077 077 077 077 077 077 077 077 077 077 077 077 077 077 077 077 077 077 077 077 077 077
077 140 100 100 177 077 077 077 077 077 077 000 000 000 000 060 060 000 000 000 000 060 077
077 060 000 002 077 060 000 000 000 000 077 077 000 000 000 000 000 060 000 000 000 000 077
077 060 002 000 002 060 000 004 060 000 060 000 000 000 000 000 000 000 060 000 000 000 077
077 060 000 002 077 060 000 000 060 000 000 000 000 000 000 000 000 000 000 060 000 000 077
077 060 000 000 077 000 000 000 060 000 000 000 000 000 000 000 000 000 000 000 060 000 077
077 077 077 077 077 000 077 000 062 000 060 000 000 000 000 000 000 000 000 000 000 060 077
077 000 000 000 000 077 077 077 077 077 077 000 000 000 000 000 000 000 000 000 000 000 077
077 000 000 000 000 000 000 000 000 000 000 000 000 000 000 000 000 000 000 000 000 000 077
077 000 000 000 000 000 000 000 000 000 000 000 000 000 000 000 000 000 000 000 000 000 077
077 000 000 000 000 000 000 000 000 000 000 000 000 000 000 000 000 000 000 000 000 000 077
077 077 077 077 077 077 077 077 077 077 077 077 077 077 077 077 077 077 077 077 077 077 077
-1 -1
-1 -1
-1 -1
-1 -1
-1 -1
-1 -1
-1 -1
-1 -1
-1 -1
-1 -1