9 6
1
21 4
177 077 077 077 077 077 077 077 077 077 077 077 077 077 077 077 077 077 077 077 077 077 077
077 060 000 000 000 000 000 000 000 000 000 000 000 000 060 000 000 000 000 000 000 060 077
077 000 000 000 000 000 000 000 000 000 060 000 000 000 000 000 000 000 077 060 000 060 077
077 000 000 000 000 000 000 000 000 177 000 000 000 000 000 000 000 000 000 000 000 002 077
077 000 000 000 000 000 000 000 000 100 000 000 000 000 000 000 000 000 000 000 000 000 077
077 000 000 000 000 000 000 000 000 100 000 000 000 000 000 000 000 000 000 000 000 077 077
077 060 000 000 000 000 000 060 000 110 000 060 000 000 000 000 000 000 000 000 002 000 077
077 000 000 000 000 000 000 002 060 000 000 060 000 000 000 000 000 060 000 002 002 000 077
077 000 000 000 000 000 000 002 002 000 000 077 000 000 000 000 000 000 000 002 060 000 077
077 000 000 000 000 000 077 000 060 000 000 000 000 000 000 000 000 000 000 000 060 000 077
077 060 000 000 000 000 000 000 077 000 000 000 000 000 000 000 000 000 000 000 000 000 077
077 077 077 077 077 077 077 077 077 077 077 077 077 077 077 077 077 077 077 077 077 077 077
9 7
8 6
10 6
21 3
1 1
14 1
1 10
11 8
-1 -1
-1 -1