1 6
4
21 7
077 077 077 077 077 077 077 077 077 077 077 077 077 077 077 077 077 077 077 077 077 077 177
077 000 000 000 000 000 000 000 000 077 000 000 000 000 000 077 077 077 077 077 077 077 077
077 000 000 060 000 060 000 000 000 060 000 000 060 060 060 077 077 060 000 060 060 000 077
077 000 000 000 000 000 000 000 077 000 077 077 000 000 002 000 000 000 000 000 000 000 077
077 000 000 000 077 000 000 000 000 004 060 077 000 000 002 002 000 000 000 000 000 000 077
077 000 000 000 077 000 000 000 000 000 000 077 000 000 000 000 000 000 000 000 000 000 077
177 100 100 100 130 000 000 000 000 060 060 002 002 000 000 060 000 000 000 000 000 000 077
077 000 000 060 000 000 000 000 077 077 077 077 000 000 000 000 000 000 000 000 000 000 077
077 077 077 077 077 077 000 000 000 000 000 000 000 000 000 000 000 000 060 060 000 000 077
077 000 000 000 000 077 000 000 000 000 000 000 000 000 000 060 060 060 077 077 060 060 077
077 000 000 000 000 077 000 000 000 000 000 000 000 000 060 060 077 077 077 077 077 077 077
077 077 077 077 077 077 077 077 077 077 077 077 077 077 077 077 077 077 077 077 077 077 077
7 6
1 2
2 2
3 7
15 8
16 7
17 6
18 5
19 4
20 3