3 10
1
15 10
177 077 077 077 077 077 077 077 077 077 077 077 077 077 077 077 077 077 077 077 077 077 077
077 060 000 000 000 000 060 000 000 000 002 000 077 060 000 000 077 000 000 000 000 000 077
077 000 000 000 000 000 060 000 000 060 002 000 002 060 000 060 077 000 000 000 000 000 077
077 060 000 000 000 000 000 000 000 000 000 077 000 000 000 000 000 000 000 000 000 000 077
077 000 077 000 000 000 000 000 000 000 077 000 000 000 000 000 000 000 000 000 000 000 077
077 060 060 060 000 000 000 000 000 000 000 000 000 000 000 000 000 000 000 000 000 000 077
077 077 060 060 000 000 000 000 000 000 000 000 000 000 060 000 000 000 000 000 000 000 077
077 060 000 060 002 002 077 000 000 000 000 000 000 000 000 000 000 000 000 000 000 000 077
077 000 000 077 000 000 000 000 000 000 000 000 000 000 000 002 000 000 000 000 000 000 077
077 060 000 160 000 000 000 000 000 000 000 000 000 000 002 002 000 000 000 000 000 000 077
077 000 000 120 000 000 000 000 000 000 000 000 000 077 000 000 000 000 000 000 000 000 077
077 077 077 077 077 077 077 077 077 077 077 077 077 077 077 077 077 077 077 077 077 077 077
1 9
1 1
14 7
14 2
15 1
4 5
4 6
-1 -1
-1 -1
-1 -1